1111110
1456311
1233231
1333131
1334331
1111111