1111110
1334310
1314311
1334331
1322231
1331351
1111111