111111
1533311
1322331
1314341
1333331
1111111