11111100
15333110
13426311
13124331
13333331
11111111