111111
153331
133241
134231
111111