1111110
1534410
1312311
1313331
1332131
1336331
1111111