0111110
1153311
1331331
1326231
1334331
1134311
0111110