01111100
11433111
13313251
13313131
13633241
13333111
11111100