11111100
13333111
13334431
13222531
13313431
11111111