1111100
1333100
1313111
1642331
1331231
1533341
1111111