111110
153311
142631
133131
133331
111111