01111110
11333311
13443331
13132221
13331541
11111111