0011110
1113310
1534211
1333231
1314331
1333331
1111111